#DO NOT USE CON, PRN, NUL, AUX, AND, NOT, VAL, RGB, ADD, ADM, DIP, MIL, INF, CAV, ART

#Varland

VAR = "countries/Varland.txt"

VAH = "countries/Varhall.txt"
ORB = "countries/Orbonfell.txt"
RUN = "countries/Runland.txt"
OSB = "countries/Osby.txt"
BER = "countries/Bern.txt"
NOR = "countries/Northel.txt"
NYK = "countries/Nykra.txt"
ICE = "countries/Icerun.txt"
FRY = "countries/Frys.txt"
GIA = "countries/Gagasla.txt"
SKU = "countries/Skund.txt"
DAR = "countries/Dargen.txt"
RAS = "countries/Rasland.txt"
TOR = "countries/Tormund.txt"
DAL = "countries/Dal.txt"
ALT = "countries/Altmund.txt"
IRN = "countries/Ironstone.txt"
GRF = "countries/Graf.txt"
ALF = "countries/Alfmark.txt"
JFR = "countries/Jofur.txt"
HRO = "countries/Hrossland.txt"
FOR = "countries/For.txt"
SAR = "countries/Sark.txt"
HAK = "countries/Hak.txt"
FAL = "countries/Falkenholm.txt"
ORM = "countries/Orms.txt"
MAL = "countries/Malkast.txt"
SKE = "countries/Skerten.txt"
ISK = "countries/Iska.txt"
ORK = "countries/Old Ryyk.txt"
GOT = "countries/Gottheim.txt"
CTD = "countries/Coldbrine Traders.txt"
HOS = "countries/Host.txt"
VRN = "countries/Varun.txt"
NRT = "countries/Northeim.txt"
LOR = "countries/Lorvik.txt"
HLY = "countries/Hallsey.txt"
HAL = "countries/Hallenheim.txt"
KIL = "countries/Kilhorn.txt"
PTD = "countries/Pearl Traders.txt"
ZAN = "countries/Zanukk.txt"
IQI = "countries/Iqiling.txt"
BOR = "countries/Borelia.txt"
PIN = "countries/Itaq Pini.txt"
UGU = "countries/Itaq Uguj.txt"
SVA = "countries/Svalheim.txt"
REY = "countries/Reykjaby.txt"
ORV = "countries/Orvik.txt"
HRU = "countries/Hrunland.txt"
UAQ = "countries/Itaq Uaq.txt"
SEA = "countries/Seahome.txt"
SOL = "countries/Solvmark.txt"
HEL = "countries/Helsing.txt"
FJO = "countries/Fjordheim.txt"
KYN = "countries/Kynshelm.txt"
FRE = "countries/Freynhall.txt"
SLE = "countries/Sleiporg.txt"
REN = "countries/Renna.txt"
HLO = "countries/Hlorma.txt"
DIO = "countries/Diobhan.txt"
SEL = "countries/Selse.txt"
ORS = "countries/Orse.txt"
VAG = "countries/Vargheim.txt"
KRN = "countries/Kron.txt"

#Briltan
HRE = "countries/Hreimgild.txt"
WGD = "countries/Whalers Guild.txt"
CAH = "countries/Cahstland.txt"
LEO = "countries/Leowib.txt"
FTD = "countries/Fish Traders.txt"
PTS = "countries/Pirates of Saidroth.txt"
OMH = "countries/Omhairn.txt"
RAL = "countries/Ralland.txt"
TUO = "countries/Tuon.txt"
NEW = "countries/Newcorpse.txt"
YWE = "countries/Ywell.txt"
DUA = "countries/Duase.txt"
DBY = "countries/Darbhy.txt"
GRE = "countries/Gresmond.txt"
KLC = "countries/Kilkrac.txt"
BLA = "countries/Blackhorse.txt"
FRG = "countries/Foregg.txt"
ORE = "countries/Orenheim.txt"
EDI = "countries/Edin.txt"
BAL = "countries/Ballan.txt"
YTE = "countries/Ytterburgh.txt"
DEB = "countries/Debbes.txt"
KIN = "countries/Kintown.txt"
CVL = "countries/Caval.txt"
UAW = "countries/Uawdhin.txt"
BRL = "countries/Briltan.txt"
AVN = "countries/Avan.txt"
GBT = "countries/Great Botte.txt"

#Highlands
CBR = "countries/Clan Brich.txt"
CDO = "countries/Clan Donagagh.txt"
CAG = "countries/Clan Aggwuhd.txt"
CAB = "countries/Clan Aberahx.txt"
CLE = "countries/Clan Leihgtr.txt"
CSL = "countries/Clan Slonath.txt"
CEL = "countries/Clan Elcnoe.txt"
TUC = "countries/The United Clans.txt"

#Achakk + Allarnia
WAR = "countries/Warshva.txt"
KEV = "countries/Kev.txt"
ETV = "countries/Ev-Tvan.txt"
OTV = "countries/Os-Tvan.txt"
TAV = "countries/Tarov.txt" 
WOW = "countries/Woodsmen of Wiel.txt"
DEW = "countries/Dewec.txt"
NIE = "countries/Niev.txt"
YEA = "countries/Yearlake.txt"
ALL = "countries/Allarnia.txt"
ORA = "countries/Ormia.txt"
VER = "countries/Verran.txt"
ACH = "countries/Achakk.txt"

#Syllos
RHO = "countries/Rhoen.txt"
SYR = "countries/Syrdal.txt"
AYA = "countries/Ayandor.txt"
MER = "countries/Mereneth.txt"
LIM = "countries/Limyer.txt"
ELE = "countries/Elen Avarim.txt"
LLA = "countries/Llanath Covenant.txt"
FEL = "countries/Fellur.txt"
DUM = "countries/Dumane.txt"
SEN = "countries/Senon.txt"
INA = "countries/Inair Thu.txt"
LIU = "countries/Liugur Phenelas.txt" 
NYA = "countries/Narinya.txt"
SOS = "countries/Syllos.txt"

#Moltran
REA = "countries/Reamoon.txt"
HUN = "countries/Hunting.txt"
ALD = "countries/Aldor.txt"
RIV = "countries/Riverway.txt"
LIN = "countries/Linderton.txt"
NLD = "countries/Nordland.txt"
MOL = "countries/Moltran.txt"
KAR = "countries/Karshire.txt"
VAY = "countries/Vayne.txt"
CHU = "countries/Churlingham.txt"
FYR = "countries/Fyrlen.txt"
WEI = "countries/Weissten.txt"
GTH = "countries/Gothram.txt"
ROS = "countries/Rossland.txt"
TIN = "countries/Tinderwood.txt"
BRN = "countries/Borne.txt"
RCH = "countries/The Reach.txt"
MAR = "countries/Marfield.txt"
PON = "countries/Ponder.txt"
BRO = "countries/Bronnland.txt"
KLT = "countries/Keltran.txt"


#Free States + Brongs + Tradeshore
MUR = "countries/Murlocke.txt"
OTE = "countries/Oten.txt"
SAN = "countries/Sandall.txt"
BRG = "countries/Brongs.txt"
PEE = "countries/Peel.txt"
SHA = "countries/Shallows.txt"
FAR = "countries/Farwind.txt"
HTD = "countries/Highsea Traders.txt"
HER = "countries/Herst.txt"
STD = "countries/Seagull Traders.txt"
CRK = "countries/Cliffer's Rock.txt"
WEL = "countries/Welding.txt"
ARR = "countries/Arrynal.txt"
BEL = "countries/Belsen.txt"
BLV = "countries/Belverdale.txt"
WHE = "countries/Wheldeross.txt"
SHZ = "countries/Shaaz.txt"
KAV = "countries/Kaverstead.txt"
PIC = "countries/Picket.txt"
SAY = "countries/Sayel.txt"
MRT = "countries/Marat.txt"
PER = "countries/Perlton.txt"
FAC = "countries/Faction Traders.txt"
FIE = "countries/Fielsnay.txt"
COV = "countries/Coverton.txt"
SAZ = "countries/Shazot.txt"
TEV = "countries/Tevan.txt"
YOR = "countries/Yorke.txt"
GRA = "countries/Grayle.txt"
SZR = "countries/Shazir.txt"

#Taroq
TAR = "countries/Taroq.txt"
NAA = "countries/Naarth.txt"
SNE = "countries/Sellaine.txt"
EVI = "countries/Evielle.txt"
ARN = "countries/Arrun.txt"
NTH = "countries/Noth.txt"
ARM = "countries/Armire.txt"
GAL = "countries/Gales.txt"
YEO = "countries/Yeoch.txt"
SNG = "countries/Senigal.txt"
FRX = "countries/Fressaux.txt"

#Teltran
TYO = "countries/Tyosse.txt"
CHA = "countries/Chambot.txt"
TER = "countries/Terl.txt"
RHY = "countries/Rhydon.txt"
EDG = "countries/Edgefield.txt"
DER = "countries/Dern.txt"
NIG = "countries/Nightvale.txt"
BRE = "countries/Breiten.txt"
ELS = "countries/Elsass.txt"
AAR = "countries/Aarnbrich.txt"
DLS = "countries/Dales.txt"
ING = "countries/Ingsbruck.txt"
BEN = "countries/Bergen.txt"
KRO = "countries/Kronnland.txt"
FNG = "countries/Foring.txt"
STE = "countries/Stern.txt"
OLD = "countries/Oldstone.txt"
RED = "countries/Redwayne.txt"
NYR = "countries/Nyrthe.txt"
KAF = "countries/Kaffhill.txt"
REU = "countries/Reuthen.txt"
TEL = "countries/Teltran.txt"

#Rivouwdn Basin
CID = "countries/Cidersprings.txt"
CEV = "countries/Cevar.txt"
SED = "countries/Seduin.txt"
DAE = "countries/Dael.txt"
RVW = "countries/Rivwoul.txt"
CII = "countries/Ciiphe.txt"
SIL = "countries/Silverlands.txt"
MRI = "countries/Merenaii.txt"
VOL = "countries/Volamis.txt"
AVA = "countries/Avantis.txt"
AYO = "countries/Ayonvir.txt"
NAI = "countries/Naital.txt"
HIG = "countries/Highwater.txt"
EVE = "countries/Evergreen Temple.txt"
CEI = "countries/Ceiison.txt"
AIR = "countries/Airoth.txt"

#Acryllia
MNT = "countries/Mercant.txt"
VIN = "countries/Vindes.txt"
PHR = "countries/Phracia.txt"
MYL = "countries/Mylade.txt"
GOL = "countries/Goldvale.txt"
MAN = "countries/Manillo.txt"
COP = "countries/Copper Traders.txt"
RET = "countries/Rettaria.txt"
VEI = "countries/Veix.txt"
AXO = "countries/Axos.txt"
OME = "countries/Omeiraam.txt"
ROM = "countries/Romenia.txt"
VIV = "countries/Vividox.txt"
GHE = "countries/Ghelticca.txt"
OLT = "countries/Old Tauria.txt"
NUR = "countries/Nurzia.txt"
MEL = "countries/Melras.txt"
VAL = "countries/Vallreix.txt"
MFZ = "countries/Marrafaz.txt"
MAE = "countries/Maetia.txt"
HAM = "countries/Hammerhills.txt"
DIA = "countries/Diana.txt"
NET = "countries/New Tauria.txt"
BRA = "countries/Brava.txt"
ANT = "countries/Antiqua.txt"
ACR = "countries/Acryllia.txt"
KAN = "countries/Kaneth.txt"
HEA = "countries/Hearten.txt"
COT = "countries/Cothonia.txt"
VEG = "countries/Vegnia.txt"
RAV = "countries/Ravona.txt"
ARK = "countries/Arkanum.txt"
PAD = "countries/Padona.txt"
ILT = "countries/Iltyr.txt"
RID = "countries/Ridas.txt"
LEN = "countries/Lenatis.txt"
THE = "countries/Thelis.txt"
THO = "countries/Thorne.txt"
NAR = "countries/Narcetia.txt"
SAS = "countries/Sascile.txt"
SNY = "countries/Snydderland.txt"
VEN = "countries/Ventria.txt"
MOT = "countries/Mothman Temple.txt"
ALE = "countries/Alletania.txt"
TAU = "countries/Tauria.txt"
LET = "countries/Lethia.txt"
 
#Nuqitut
ANU = "countries/Anumal.txt"
QOS = "countries/Qoss.txt"
UKA = "countries/Ukaraa.txt"
IIM = "countries/Iimeata.txt"
NUQ = "countries/Nuqunaq.txt"
KON = "countries/Konairsal.txt"
AQL = "countries/Aqla.txt"

#Isschi
PAL = "countries/Paldar.txt"
SLU = "countries/Selluin.txt"
TEA = "countries/Tear.txt"
ISS = "countries/Isschi.txt"
ILL = "countries/Illuin.txt"
MOP = "countries/Mopar.txt"
LOT = "countries/Lotsi.txt"
ICW = "countries/Icewind.txt"

#Dvarlendur
YOT = "countries/Yothr.txt"
DRA = "countries/Drakum.txt"
STA = "countries/Staaldum.txt"
THR = "countries/Throl.txt"
KOS = "countries/Koserak.txt"
BOE = "countries/Boernum.txt"
REK = "countries/Rekurn.txt"
DVE = "countries/Dvernum.txt"
REI = "countries/Reinduruk.txt"
OBE = "countries/Obenural.txt"
ALK = "countries/Alkastum.txt"
SOU = "countries/Southstone.txt"
GHD = "countries/Greyhold.txt"
ATM = "countries/Altum.txt"
MIN = "countries/Minum.txt"
BKV = "countries/Braukvei.txt"
JOR = "countries/Jork.txt"
JUT = "countries/Jutdum.txt"
KVI = "countries/Kvinum.txt"
DOE = "countries/Doernum.txt"
RAE = "countries/Raeger.txt"
JOF = "countries/Joforum.txt"
THA = "countries/Thaumerk.txt"
KAA = "countries/Kaarum.txt"
DRE = "countries/Drebynum.txt"
DVA = "countries/Dvarlendur.txt"

#Halmskr
IRO = "countries/Ironhelm.txt"
BRI = "countries/Briihk.txt"
VEH = "countries/Vehk.txt"
NGO = "countries/Ngon.txt"
MAZ = "countries/Mazan.txt"
BWA = "countries/Bwane.txt"
AKA = "countries/Akashra.txt"
LOS = "countries/Lost Orcs.txt"
TRE = "countries/Tredahk.txt"
ADR = "countries/Adrak.txt"
NAS = "countries/Nashde.txt"
SHI = "countries/Shieldpeak.txt"
RAG = "countries/Ragraz.txt"
AMN = "countries/Almon.txt"
WHI = "countries/White Rock.txt"
GAR = "countries/Garakh.txt"
DOO = "countries/Doom.txt"
KAS = "countries/Kash.txt"
JAR = "countries/Jarbek.txt"
SKA = "countries/Skaven.txt"
BOS = "countries/Bosant.txt"
KOL = "countries/Kolsant.txt"
PAN = "countries/Pan.txt"
BLD = "countries/Belur Dashak.txt"
CHO = "countries/Chondar.txt"
MAG = "countries/Magkchezd.txt"
RON = "countries/Ronvim.txt"
OMA = "countries/Omag.txt"
LUK = "countries/Lukezi.txt"
MAU = "countries/Maul.txt"
ASH = "countries/Ashkaz.txt"
TUL = "countries/Tulshu.txt"
TRS = "countries/Tarsu.txt"
LDA = "countries/Ldan.txt"
STO = "countries/Stonehall.txt"
ANV = "countries/Anvar.txt"
ORH = "countries/Orhone.txt"
SHN = "countries/Stahn.txt"
BKW = "countries/Blackwall.txt"
GON = "countries/Golnam.txt"
ULG = "countries/Ulgyz.txt"
ILB = "countries/Ilben.txt"
DWE = "countries/Dwen.txt"
HLM = "countries/Halmskr.txt"
MDA = "countries/Mdarak.txt"

#Gorsand
KHA = "countries/Khashan.txt"
GUZ = "countries/Guzul.txt"
JOM = "countries/Jom.txt"
DMO = "countries/Dmon.txt"
VAN = "countries/Varan.txt"
WAT = "countries/Waterpoint.txt"
BFY = "countries/Blackfyhr.txt"
TBA = "countries/Tban Sha.txt"
MNN = "countries/Minan.txt"
QAS = "countries/Qashan.txt"
GOR = "countries/Gorsand.txt"

#Elldranor + Tavrayll
BLE = "countries/Bleak.txt"
ASV = "countries/Ashla Val.txt"
WES = "countries/Westrim.txt"
IND = "countries/Indrys.txt"
STN = "countries/Stal Num.txt"
RUS = "countries/Rusk.txt"
ALV = "countries/Allvos.txt"
BRS = "countries/Blackrose.txt"
ESM = "countries/Esmere.txt"
DUS = "countries/Duskvale.txt"
MOG = "countries/Mogrul Kash.txt"
KRV = "countries/Kryn Val.txt"
CLA = "countries/Clath Num.txt"
MYV = "countries/Myrath Val.txt"
MAA = "countries/Mana.txt"
VLM = "countries/Volmar.txt"
VRT = "countries/Verant.txt"
NUV = "countries/Nulvar.txt"
NAV = "countries/Naava.txt"
ALM = "countries/Almorr.txt"
ARA = "countries/Ararak.txt"
LOV = "countries/Lovash.txt"
VMA = "countries/Varmia.txt"
DZY = "countries/Dzyn.txt"
TYL = "countries/Tavrayll.txt"
ELL = "countries/Elldranor.txt"

#Sunset Isle
ANO = "countries/Anowe.txt"
DAW = "countries/Dawn.txt"
SIR = "countries/Sireth.txt"
ULD = "countries/Uldan.txt"
SEW = "countries/Seawatch.txt"
RUL = "countries/Runeland.txt"
KAI = "countries/Kai Mund.txt"
UTE = "countries/Uteya.txt"
ECA = "countries/Ecas.txt"
RIF = "countries/Riftland.txt"
DOT = "countries/Dothrin.txt"
SLV = "countries/Silavia.txt"
GIL = "countries/Gildur.txt"
KAE = "countries/Kalas Aed.txt"

#Lyzania
NOK = "countries/No Katek.txt"
SUL = "countries/Suld.txt"
ZON = "countries/Zond.txt"
HAJ = "countries/Haj.txt"
GOZ = "countries/Gozma.txt"
ILR = "countries/Il Rohguz.txt"
DMT = "countries/Darkmist.txt"
KOG = "countries/Kogru'un.txt"
SYL = "countries/Sylten.txt"
PEA = "countries/Pearl.txt"
VUJ = "countries/Vuj Shatar.txt"
AZT = "countries/Az Thim.txt"
NAH = "countries/Nahm'isst.txt"
GAZ = "countries/Gazak.txt"
STH = "countries/St'hilmar.txt"
DON = "countries/Dongaran.txt"
EVR = "countries/Evermore.txt"

#Great Forest
VAT = "countries/Vatoma.txt"
TRA = "countries/Trader's Post.txt"
AFA = "countries/Afar.txt"
OKY = "countries/Okymbe.txt"
AMB = "countries/Amba.txt"
SLK = "countries/Selake.txt"
FIA = "countries/Fian.txt"
LAM = "countries/Lamp.txt"
IVO = "countries/Ivo.txt"
MFE = "countries/Manafe.txt"
MHA = "countries/Maha.txt"
TVL = "countries/Tvala Lak.txt"

#Falfedo
OLH = "countries/Oldheart.txt"
ULF = "countries/Ulfedo.txt"
ADN = "countries/Aldano.txt"
WIN = "countries/Windleaf Vale.txt"
TRT = "countries/Thornroot.txt"
AST = "countries/Astae.txt"
TWE = "countries/Twen.txt"
WIT = "countries/Wittan.txt"
ELM = "countries/Elmedo.txt"
BOK = "countries/Bokedo.txt"
ROO = "countries/Root.txt"
UWO = "countries/Uwon.txt"
ERE = "countries/Erefion.txt"
DRU = "countries/Druthe.txt"
FFD = "countries/Falfedo.txt"
RIW = "countries/Riverwood.txt"
FLU = "countries/Flute.txt"

#Naktaviri
ZEI = "countries/Zeiyet.txt"
NAK = "countries/Naktaviri.txt"
SHU = "countries/Shurres.txt"
ABE = "countries/Abere.txt"
PRE = "countries/Prene.txt"
KRA = "countries/Kravane.txt"
DUR = "countries/Durris.txt"
SHQ = "countries/Shqike.txt"
LIB = "countries/Libraz.txt"
TIR = "countries/Tirol.txt"
LRC = "countries/Lorce.txt"
FLS = "countries/Fellspar.txt"
SHK = "countries/Shkana.txt"
SSP = "countries/Shadowspire.txt"

#Awapetanh
SAI = "countries/Saire.txt"
KES = "countries/Kester.txt"
KAW = "countries/Kawn.txt"
REM = "countries/Remk.txt"
SOR = "countries/Sorrolok.txt"
AWL = "countries/Awlon.txt"
KNT = "countries/Kanata.txt"
SGA = "countries/Sgaw.txt"
WEG = "countries/Wegan.txt"
MAH = "countries/Mahana.txt"
CHK = "countries/Chaleske.txt"
ANA = "countries/Anado.txt"
AHA = "countries/Asheda.txt"
GWA = "countries/Gwageh.txt"
IWE = "countries/Iwenwi.txt"
TEN = "countries/Tene.txt"
DEG = "countries/Dega.txt"
KOP = "countries/Kopi.txt"
AAK = "countries/Aaksi.txt"
MTN = "countries/Moton.txt"
HAA = "countries/Haan.txt"
KOK = "countries/Kopki.txt"
IRQ = "countries/Ironuqil.txt"
WOL = "countries/Wolflands.txt"
HTA = "countries/Hta.txt"
KIS = "countries/Kisonak.txt"
EWO = "countries/Ewone.txt"
TEW = "countries/Tewesti.txt"
SIP = "countries/Sipih.txt"
ATO = "countries/Atobana.txt"
WWG = "countries/Westawouganie.txt"
WAN = "countries/Wangou.txt"
KWK = "countries/Kelwaku.txt"
KIC = "countries/Kichista.txt"
OCH = "countries/Ochas.txt"
GLK = "countries/Great Lake Kingdom.txt"

#Broken lands/Trovenam
WHR = "countries/Whale Raiders.txt"
STY = "countries/Styre.txt"
PTF = "countries/Pirates of the Tenth Flag.txt"
MRP = "countries/Maroon Pirates.txt"
KRZ = "countries/Kraz.txt"
VAU = "countries/Vauckland.txt"
LPT = "countries/Little Port.txt"
YOS = "countries/Yosh.txt"
SAD = "countries/Sadal.txt"
NTR = "countries/New Trovenam.txt"
PEL = "countries/Pell.txt"
LUC = "countries/Lucker's Point.txt"
PRC = "countries/Pirec.txt"
DRD = "countries/Dread.txt"
SPI = "countries/Spiceport.txt"
TRV = "countries/Trovenam.txt"

#Tyrfak+Dragontail Mts
STP = "countries/Stoneport.txt"
FAK = "countries/Farak.txt"
DUI = "countries/Duinbar.txt"
KRH = "countries/Karahin.txt"
FRK = "countries/Frek.txt"
TYR = "countries/Tyrfak.txt"
TRN = "countries/Thoron.txt"
FII = "countries/Fiironvar.txt"
ROH = "countries/Rohel.txt"
DVL = "countries/Dragon Vale.txt"
VLD = "countries/Volradanach.txt"
FVL = "countries/Forgevale.txt"
BHA = "countries/Bharat.txt"
GHO = "countries/Ghorama.txt"
HET = "countries/Hetwal.txt"
SUD = "countries/Sudurpash.txt"
LOK = "countries/Lokha.txt"
CHP = "countries/Chandipur.txt"
CHI = "countries/Chimat.txt"
GAN = "countries/Ganral.txt"
RAU = "countries/Rautal.txt"
BHU = "countries/Bhumshi.txt"
BAN = "countries/Bhan.txt"
LUM = "countries/Luma.txt"

#Emidyne Steppe
KEL = "countries/Keltan.txt"
SNT = "countries/Sent.txt"
SON = "countries/Sondeth.txt"
PAR = "countries/Parth.txt"
NYM = "countries/Nym.txt"
BLW = "countries/Bellows.txt"
DOR = "countries/Doron.txt"
GLT = "countries/Gilton.txt"
RAA = "countries/Raal.txt"
KAD = "countries/Kadif.txt"
SOM = "countries/Somare.txt"
MTY = "countries/Mantasy.txt"
MRM = "countries/Mersirum.txt"
SAF = "countries/Safrum.txt"

#Bahdakur
AMD = "countries/Amdorra.txt"
BAS = "countries/Bastahn.txt"
KRI = "countries/Krivara.txt"
MRN = "countries/Martain.txt"
AMA = "countries/Arman.txt"
AZK = "countries/Azkesh.txt"
OMI = "countries/Omir.txt"
ZEM = "countries/Zemir.txt"
YAZ = "countries/Yazin.txt"
JHI = "countries/Jhistal.txt"
SHP = "countries/Sheppal.txt"
ALR = "countries/Has Alrak.txt"
MJZ = "countries/Maja Zamk.txt"
MUD = "countries/Mudhrat.txt"
GHA = "countries/Ghasri.txt"
BAJ = "countries/Basjah.txt"
NBY = "countries/Narabaye.txt"
HQI = "countries/Has Qimon.txt"
MEY = "countries/Meyja.txt"
HES = "countries/Hestan.txt"
DEJ = "countries/Dejar.txt"
HKU = "countries/Has Kurim.txt"
ZAR = "countries/Zarb.txt"
QUS = "countries/Qushul Abeq.txt"
SHM = "countries/Shamas.txt"
HUB = "countries/Has Ubrid.txt"
ESH = "countries/Eshas.txt"
RAM = "countries/Raman.txt"
AQA = "countries/Aqab.txt"
MUS = "countries/Musrat Shelfim.txt"
ASS = "countries/Assassins Guild.txt"
KEW = "countries/Keswar.txt"
HEB = "countries/Has Ebrin.txt"
MIS = "countries/Misrata.txt"
HBL = "countries/Hebril.txt"
MHR = "countries/Mahrab.txt"
HNU = "countries/Has Nusin.txt"
ARS = "countries/Artesh.txt"
YEM = "countries/Yemenkaru.txt"
JID = "countries/Jiddhan.txt"
AKK = "countries/Akkan.txt"
HAC = "countries/Has Achem.txt"
QAL = "countries/Qalar.txt"
TWA = "countries/Tas'Wa.txt"
UFR = "countries/Ufrih.txt"
HHA = "countries/Has Hara.txt"
UHA = "countries/Uhmal At.txt"
OAS = "countries/Oasis.txt"
SAT = "countries/Shubriq At.txt"
NAD = "countries/Nadeen.txt"
QSH = "countries/Qashul.txt"
DUN = "countries/Dune.txt"
HBR = "countries/Has Breneh.txt"
RAT = "countries/Ratas.txt"
HUH = "countries/Has Ubileh.txt"
WAS = "countries/Wasun.txt"
ADA = "countries/Adael.txt"
HIM = "countries/Has Imras.txt"
KHS = "countries/Khas.txt"
RUH = "countries/Ruhn.txt"
DRR = "countries/Derre.txt"
ERL = "countries/Erlat.txt"

#rest of Astrea
DIN = "countries/Dinar.txt"
WAL = "countries/Walando.txt"
BRV = "countries/Bravu.txt"
CAY = "countries/Cayyos.txt"
AVS = "countries/Akavos.txt"
KAY = "countries/Kary.txt"
LIS = "countries/Lisstar.txt"
GHZ = "countries/Ghazin.txt"
WFU = "countries/Wad e Fustat.txt"
HRA = "countries/Hranmal.txt"
BSH = "countries/Barshal.txt"
PAM = "countries/Pandam.txt"
ZAG = "countries/Zangh.txt"
KAJ = "countries/Kajan.txt"
ASA = "countries/Assan.txt"
PRA = "countries/Prajat.txt"
VIT = "countries/Vittom.txt"
PUN = "countries/Punghal.txt"
KER = "countries/Kerram.txt"
JAM = "countries/Jambhit.txt"
ROT = "countries/Roti.txt"
MAJ = "countries/Majun.txt"
QOL = "countries/Qolshar.txt"
RLO = "countries/Ralento.txt"
VIJ = "countries/Vijung.txt"
KSP = "countries/Kaspadra.txt"
BEG = "countries/Bengham.txt"
TUV = "countries/Tuvua.txt"
TAY = "countries/Tayeo.txt"
NVI = "countries/Nukul Vilo.txt"
COR = "countries/Coral.txt"
KIV = "countries/Kita Vilo.txt"
MOV = "countries/Motu Vilo.txt"
BLU = "countries/Bluethorn.txt"
IKA = "countries/Ikathya.txt"
TOM = "countries/Tomara.txt"
MAK = "countries/Makeda.txt"
NKA = "countries/Nokama.txt"
ABA = "countries/Ashaba.txt"
HAD = "countries/Hadruhn.txt"
KOY = "countries/Koyt.txt"
BAD = "countries/Badahyan.txt"
CET = "countries/Cetrea.txt"
SOY = "countries/Soyun.txt"
GOK = "countries/Gokel.txt"
ADV = "countries/Adventurers Company.txt"
SUK = "countries/Sukhul.txt"
GUE = "countries/Guernley.txt"
VEX = "countries/Vex.txt"
VLT = "countries/Valant.txt"
BLS = "countries/Black Sail.txt"
FKP = "countries/Flame Keep.txt"
NGH = "countries/Nightland.txt"
RVG = "countries/Ravenguard.txt"
ATL = "countries/Atley.txt"
DME = "countries/Deepmure.txt"
MDK = "countries/Mandokhol.txt"
KRS = "countries/Khat Riders.txt"
OHT = "countries/Ã–htor.txt"
LHE = "countries/Lheydam.txt"
KHL = "countries/Khaleem.txt"
CHG = "countries/Chugal.txt"
MON = "countries/Monlaa.txt"
KHG = "countries/Khagas.txt"
SKT = "countries/Sukutar.txt"
ABL = "countries/Awkri Balbage.txt"
SEP = "countries/Sephir.txt"
DRM = "countries/Dremor.txt"
BAG = "countries/Blackgate.txt"
POV = "countries/Principality of Vice.txt"
QUI = "countries/Quiwin.txt"
WYE = "countries/Wyeeroong.txt"
NEE = "countries/Neera.txt"
KTT = "countries/Krattang.txt"
SKN = "countries/Shakran.txt"
KUA = "countries/Kuarbei.txt"
ASR = "countries/Ashar.txt"
OSU = "countries/Osul.txt"
BHN = "countries/Barahun.txt"
PLS = "countries/Palash.txt"
AGA = "countries/Awkri Gabbak.txt"
AEL = "countries/Awkri Elan.txt"
AGO = "countries/Awkri Goondjea.txt"
RHA = "countries/Rhaang.txt"
SRZ = "countries/Saruz Empire.txt"
ISO = "countries/Isopor.txt"
FER = "countries/Ferhun.txt"
MOS = "countries/Mosan.txt"
BGH = "countries/Baghana.txt"
AZA = "countries/Azandara.txt"
ESU = "countries/Eshur.txt"
SYS = "countries/Says.txt"
WGG = "countries/Wonggem.txt"
NAC = "countries/Nacib.txt"
EHR = "countries/Esharr.txt"
FUA = "countries/Fuad.txt"
SHT = "countries/Shirat.txt"
ULA = "countries/Ulat.txt"
CAS = "countries/Casiin.txt"
TAW = "countries/Tawezuk.txt"
ZAW = "countries/Zawrata.txt"
KAQ = "countries/Kana Qaftan.txt"
HAQ = "countries/Hajji Qaftan.txt"
QAR = "countries/Qariim.txt"
OCC = "countries/Occult.txt"
DHA = "countries/Dhaccim.txt"
SKI = "countries/Skein.txt"
WPT = "countries/Whaleport.txt"
SAA = "countries/Shathra.txt"
LIL = "countries/Lilac.txt"
OKR = "countries/Okrul.txt"
BAK = "countries/Bakhast.txt"
SCA = "countries/Scar.txt"
RVR = "countries/Reaver.txt"
DLM = "countries/Dass Lehm.txt"
MEH = "countries/Mehy Lehm.txt"
QUF = "countries/Qwatri u Fari.txt"
AHK = "countries/Ahkai.txt"
QOH = "countries/Qoha.txt"
REF = "countries/Refeda.txt"
TAN = "countries/Tanif.txt"
SMA = "countries/Smar.txt"
CHN = "countries/Chains.txt"
SHD = "countries/Shade.txt"
AGH = "countries/Aghanim.txt"
DGT = "countries/Despots Gate.txt"
BKH = "countries/Barkanash.txt"
VRL = "countries/Verile.txt"
QAT = "countries/Qatul.txt"
NEF = "countries/Nefrat.txt"
SNW = "countries/Senwat.txt"
THT = "countries/Thaten.txt"
RMT = "countries/Ramet.txt"
IWN = "countries/Iwenesh.txt"
RAW = "countries/Raswat.txt"
THB = "countries/Thebe.txt"
PSO = "countries/Psorom.txt"
KHU = "countries/Khuf.txt"
WRU = "countries/Wasruk.txt"
MOC = "countries/Mocwa.txt"
CAT = "countries/Catul.txt"
SHF = "countries/Shefrim.txt"
UDA = "countries/Udana.txt"
OUA = "countries/Ouan.txt"
SAH = "countries/Sahidan.txt"
AVE = "countries/Avea.txt"
GRY = "countries/Grey Islands.txt"
TEH = "countries/Tehron.txt"
ASL = "countries/Ashlands.txt"
NBX = "countries/Nubax.txt"
BAH = "countries/Bahdakur.txt"
ITH = "countries/Ithola.txt"
MHD = "countries/Mehedruhn.txt"
HAN = "countries/Handaan.txt"
TBE = "countries/The Broken Empire.txt"
BLI = "countries/Blue Isles.txt"
MJK = "countries/Majukistan.txt"
ZEK = "countries/Zekrat.txt"
CTQ = "countries/Cataqan.txt"
SLS = "countries/Slavers Shore.txt"
BSK = "countries/Bashkal.txt"
ANH = "countries/Anhya.txt"
AWK = "countries/Awk Ewaggi.txt"
CAP = "countries/The Cape.txt"

#Emea/Orea
JAT = "countries/Jatharn.txt"
OST = "countries/Ostviel.txt"
SFF = "countries/Saffen.txt"
TUR = "countries/Turbjut.txt"
KAT = "countries/Kator.txt"
WLS = "countries/Wells.txt"
CRA = "countries/Crabbe.txt"
SYY = "countries/Sayyos.txt"
PAJ = "countries/Pajshrit.txt"
LAS = "countries/Lash.txt"
ISH = "countries/Ishtar.txt"
AGD = "countries/Agad.txt"
SPR = "countries/Sippar.txt"
TBZ = "countries/Thembazi.txt"
NGX = "countries/Ngonxo.txt"
KWO = "countries/Kwondi.txt"
ITK = "countries/Ithakanago.txt"
AKU = "countries/Akan Urul.txt"
SHY = "countries/Shamys.txt"
MSH = "countries/Mash.txt"
KUD = "countries/Kud Alon.txt"
RAD = "countries/Radnec.txt"
BR0 = "countries/Bron.txt"
KVC = "countries/Kavice.txt"
EDR = "countries/Elder's Rock.txt"
SCK = "countries/Sulcek.txt"
KOR = "countries/Kornost.txt"
MGU = "countries/Magi Urul.txt"
CAI = "countries/Caimacan.txt"
TRY = "countries/Temaray.txt"
WAI = "countries/Waitirim.txt"
JUA = "countries/Juachal.txt"
KA1 = "countries/Kai .txt"
MNG = "countries/Murinagar.txt"
KSN = "countries/Khasan.txt"
TJA = "countries/Taloja.txt"
SKR = "countries/Shikar.txt"
BHD = "countries/Bhadrasim.txt"
JUN = "countries/Junpot.txt"
AHJ = "countries/Ahjun.txt"
TVS = "countries/Torvas.txt"
BHJ = "countries/Bahoj.txt"
PMR = "countries/Pamar.txt"
VIE = "countries/Vietrang.txt"
CHH = "countries/Chimounh.txt"
QUC = "countries/Quan Ci.txt"
TNA = "countries/Thuan Na.txt"
AHU = "countries/Anhua.txt"
BNH = "countries/Binh Hoc.txt"
YEC = "countries/Yen Ci.txt"
HNM = "countries/Hunam.txt"
DOK = "countries/Dong Ki.txt"
SUP = "countries/Suphoan.txt"
REP = "countries/Rephoan.txt"
MUA = "countries/Muang Rung.txt"
KHM = "countries/Khmon.txt"
SIK = "countries/Sihkampong.txt"
QUV = "countries/Quanvo.txt"
XIE = "countries/Xiet.txt"
LUO = "countries/Luong That.txt"
PHI = "countries/Phitsouk.txt"
BGL = "countries/Banglei.txt"
LGT = "countries/Lang Tang.txt"
SAW = "countries/Sawathayya.txt"
KHC = "countries/Khuchang.txt"
LPH = "countries/Lamphat.txt"
PAI = "countries/Padai.txt"
KHP = "countries/Khamphung.txt"
BUE = "countries/Buenthabur.txt"
SHO = "countries/Shomkeut.txt"
ASQ = "countries/Ashqerom.txt"
TIT = "countries/Titan's Fist.txt"
IRA = "countries/Iraav.txt"
NEZ = "countries/Nezhar.txt"
TPL = "countries/The Pale.txt"
NEC = "countries/Necros.txt"
BKK = "countries/Brukkar.txt"
SWA = "countries/Swanville.txt"
SHX = "countries/Shei Xin.txt"
XAR = "countries/Xarabo.txt"
RAK = "countries/Rak.txt"
BHO = "countries/Bhomo.txt"
NAY = "countries/Naypith.txt"
MYW = "countries/Mywadan.txt"
PYA = "countries/Pya-U.txt"
HPA = "countries/Hpani.txt"
SDL = "countries/Shandalai.txt"
TDN = "countries/Thadon.txt"
KYU = "countries/Kyato-U.txt"
AYE = "countries/Ayer.txt"
SLI = "countries/Salthuli.txt"
YAN = "countries/Yanghine.txt"
TWY = "countries/Taway.txt"
MYI = "countries/Myi.txt"
RKY = "countries/Rakwady.txt"
KPN = "countries/Kera'pen'nur.txt"
KUN = "countries/Kon'uk'nur.txt"
NPN = "countries/Noya'pay'nur.txt"
ATS = "countries/Atseida.txt"
ATA = "countries/Amata.txt"
UES = "countries/Uesoda.txt"
INU = "countries/Inu.txt"
SOK = "countries/Sokura.txt"
HOM = "countries/Homaga.txt"
ONI = "countries/Onimo.txt"
OND = "countries/Onda.txt"
ERO = "countries/Erodai.txt"
TSU = "countries/Tsuna.txt"
HAI = "countries/Haima.txt"
CHE = "countries/Cheonju.txt"
DAS = "countries/Dasea.txt"
SIN = "countries/Sinchon.txt"
CHJ = "countries/Chajeo.txt"
BUG = "countries/Bugeon.txt"
SUY = "countries/Suyoo.txt"
DXG = "countries/Donxing.txt"
HLG = "countries/Hanlong.txt"
NIN = "countries/Ninhar.txt"
BEI = "countries/Bei Lon.txt"
DJG = "countries/Danjiang.txt"
ONC = "countries/Onchu.txt"
SHE = "countries/Shen.txt"
ANC = "countries/Anchuan.txt"
ZUX = "countries/Zuxian.txt"
JIX = "countries/Jixyun.txt"
BAO = "countries/Baoling.txt"
HZI = "countries/Haizi.txt"
NCG = "countries/Nancheng.txt"
ZHU = "countries/Zhu.txt"
MEI = "countries/Meilin.txt"
GUA = "countries/Guanglo.txt"
SYU = "countries/South Yun.txt"
YUJ = "countries/Yujiang.txt"
CXG = "countries/Chenxiong.txt"
NYU = "countries/North Yun.txt"
B4N = "countries/Ban.txt"

# = "countries/.txt"